


                                          C C C                                  ||
                                          ■■■■■                                  |
                                   ■■■■■                                         |
                            ■■■■■                                                |
                     ■■■■■                                                       |
              ■■■■■                                                              |
J      ■■■■■                                                                     |
■    ■    ☉    ■    ■    ☉    ■    ■    ☉    ■                                 |
■■■■■■■■■■■■■■■■■■■■■■■■■■■■■■■■■■■■■■■■■■■■■■■■■■■■■■■■■■■■■■■■■■■■■■■■■■■■■■■■|■|■■■




















