


        □     □     □     C     C     C                                             ||
J       ■     ■     ■                                                               |
■■■■■                                                                               |
        ■■■■■                                                                       |
              ■■■■■                                                                 |
                    ■■■■■                                                           |
                          ■■■   ■ ☉ ■   ■■■   ■ ☉ ■   ■■■   ■ ☉ ■   ■■■■■■■■■■■■■■|■|■■■

🟦🟦🟦🟦🟦🟦🟦🟦🟦🟦🟦🟦🟦🟦🟦🟦🟦🟦🟦🟦🟦🟦🟦🟦🟦🟦🟦🟦🟦🟦🟦🟦🟦🟦🟦🟦🟦🟦🟦🟦🟦🟦🟦🟦🟦🟦🟦🟦🟦🟦🟦🟦




















