



                C C C                □ □ □                                  ||
                ■■■■■                                                       |
        □ □                                                                 |
J                                                                           |
■                                                                           |
■■■■■■■■■■■■     ■■■■■■■■■■■■■■■     ■■■■■■■■■■■■■■■■■     ■■■■■■■■■■■■■■■|■|

                    ☉                       ☉                    ☉
🟦🟦🟦🟦🟦🟦🟦🟦🟦🟦🟦🟦🟦🟦🟦🟦🟦🟦🟦🟦🟦🟦🟦🟦🟦🟦🟦🟦🟦🟦🟦🟦🟦🟦🟦🟦🟦🟦🟦🟦🟦🟦🟦🟦🟦🟦🟦🟦🟦🟦🟦🟦🟦



















